NO ./textures/red_brick.xpm
SO ./textures/red_wall.xpm
WE ./textures/brick_purple.xpm
EA ./textures/glowing_wall.xpm

F 231,206,28
C 102,175,214

11111111111111111111111111111111111111
  100000000000101000000000100011010111111
  1010000000000000001111000000100000011111111
 1010000N000000000000000011000000000010000001
 10000000011000011000100000010000000011010000111
 10011110000000110000110000001000011100110000011
11001111111110110000000000000000000001100010011
11001110001110000010011000000001000010000010001
 1111000001101010110000000000000000000100001111   
1000000000000001100000000010010101010111011111111111
1001100000000001000010000000111011100001111111111111
1111111111111111111111111111111111111111111111111111
