NO ./maps/textures/LavaF2.xpm
SO ./maps/textures/Bricks.xpm
WE ./maps/textures/Sand.xpm
EA ./maps/textures/WoolSnow.xpm

C 51,53,51
F 36,85,1

		1111111111111111111111111
		1000000000110000000000001
		100000000011000000000N001
		1011000000000000000000001
		1001000000000000000000001
111111111011000001110000000000001
100000000011000001110111111111111
11110111111111011100000010001
11110111111111011101010010001
11000000110101011100000000001
10000000000000001100000010001
10000000000000001100000010001
100000000000000011010100100011111
110000011101010111110111100000001
11110111 1110101 1 1111 10001111
11111111 1111111 111111111111 111