NO ./maps/textures/Grass.xpm
SO ./maps/textures/Ice.xpm
WE ./maps/textures/Gold0.xpm
EA ./maps/textures/Gold1.xpm

C 51,53,51
F 36,85,1

1111111111111111111111111
1000000000000000000000001
100000000000000000000W001
1000000000000000000000001
1111111111111111111111111